WIDTH=19
HEIGHT=13
BALL_COLORS=1.0,0.4,0.4;0.4,0.4,1.0

###################
#        #        #
#        #        #
# 1  #   #   #  A #
#    #       #    #
#    #       #    #
###################
#    #       #    #
#    #       #    #
# 2  #   #   #  B #
#        #        #
#        #        #
###################
