WIDTH=23
HEIGHT=13
BALL_COLORS=1.0,0.4,0.4;0.4,0.4,1.0

#######################
#          #          #
#          #          #
#     #    #    #     #
# 1   #  #####  # B A #
#     #  #   #  #     #
#     #    a    #     #
#     #         #     #
#################!!!!!#
#                     #
# 2                   #
#                     #
#######################
