WIDTH=23
HEIGHT=17
BALL_COLORS=1.0,0.4,0.4;0.4,0.4,1.0

#######################
#          #          #
#        #####        #
##########   #        #
#                     #
# 1        a       B  #
#                     #
##########   #        #
#        #####        #
#          #          #
#          ######!!!!!#
#                     #
#                     #
# 2                A  #
#                     #
#                     #
#######################
